00000000000000000000
11111111111111111110
00000000000000000010
01111111111111111010
01000000000000001010
01011111111111101010
01010000000000101010
01010111111110101010
01010100000010101010
01010100000000101010
01010111111111101010
01010000000000001010
01011111111111111010
01000000000000000010
01111111111111111110
00000000000000000000